#######
# .   #
#.$@$$#
#   . #
#     #
#######