########
#      #
#      #
# .# . #
#  $ $ #
#  @   #
########
